ZSP	= "countries/ZSP.txt" #northern spain/galicia
ZPR = "countries/ZPR.txt" #portugal
ZBL = "countries/ZBL.txt" #baleric islands
ZSS = "countries/ZSS.txt" #southern spain
ZPT = "countries/ZPT.txt" #central france
ZNR = "countries/ZNR.txt" #normandy
ZAL = "countries/ZAL.txt" #alpine
ZBR = "countries/ZBR.txt" #burgundy
ZBE = "countries/ZBE.txt" #belgium
ZWG = "countries/ZWG.txt" #west germany
ZEG = "countries/ZEG.txt" #austria-bavaria-bohemia
ZUM = "countries/ZAM.txt" #austro-moravia
ZSH = "countries/ZSH.txt" #schleswig-hannover
ZBS = "countries/ZBS.txt" #berlin-saxony
ZVN = "countries/ZVN.txt" #venice
ZCB = "countries/ZCB.txt" #dalmatiabosnia
ZCH = "countries/ZCH.txt" #hungary slavonia
ZAS = "countries/ZAS.txt" #albania serbia
ZSR = "countries/ZSR.txt" #greece/bulgaria serres
ZPN = "countries/ZPN.txt" #https://en.wikipedia.org/wiki/Greater_Poland_uprising_(1918%E2%80%931919)
ZUP = "countries/ZUP.txt" #Transylvanian-Moldovan union lmao
ZHS = "countries/ZHS.txt" #hungary-serbs
ZZA = "countries/ZZA.txt" #aragon-basque-bordeaux
ZAA = "countries/ZAA.txt" #aland island 
ZEV = "countries/ZEV.txt" #estonia-latvia
ZCU = "countries/ZCU.txt" #greater courland+lithuania
ZZP = "countries/ZZP.txt" #mini zapadoslavia
ZWZ = "countries/ZWZ.txt" #warsaw
ZSC = "countries/ZSC.txt" #denmark-scania
ZLW = "countries/ZLW.txt" #carpathian ruthenia-lwow
ZKR = "countries/ZKR.txt" #karelia-south Finland
ZMK = "countries/ZMK.txt" #murmansk-north finland-north sweden two wn
ZSW = "countries/ZSW.txt" #most of sweden
ZDN = "countries/ZDN.txt" #dnieper river
ZWN = "countries/ZWN.txt" #wilno-most of belarus
ZIZ = "countries/ZIZ.txt" #west anatolian coast